7 5 2
#######
#....*#
##...##
#*....#
#######
1 1
3 1
3 2